0,1,2,3,0,1,2,3,0,1,2,3,0,1,2,3,0,1,2,3,0,1,2,3,5,6,7,8,9,10
12,13,14,15,12,13,14,15,12,13,14,15,12,13,14,15,12,13,14,15,12,13,14,15,17,18,19,20,21,22
24,25,26,27,24,25,26,27,24,25,26,27,24,25,26,27,24,25,26,27,24,25,26,27,29,30,31,32,33,34
36,37,38,39,36,37,38,39,36,37,38,39,36,37,38,39,36,37,38,39,36,37,38,39,41,42,43,44,45,46
48,49,50,51,48,49,50,51,48,49,50,51,48,49,50,51,48,49,50,51,48,49,50,51,53,54,55,56,57,58
60,61,62,63,60,61,62,63,60,61,62,63,60,61,62,63,60,61,62,63,60,61,62,63,65,66,67,68,69,70
72,73,74,75,72,73,74,75,72,73,74,75,72,73,74,75,72,73,74,75,72,73,74,75,77,78,79,80,81,82
84,85,86,87,84,85,86,87,84,85,86,87,84,85,86,87,84,85,86,87,84,85,86,87,89,90,91,92,93,94
