0,1,2,3,0,1,2,3,0,1,2,3,0,1,2,3,0,1,2,3,0,1,2,3,5,6,7,8,9,10
24,25,26,27,24,25,26,27,24,25,26,27,24,25,26,27,24,25,26,27,24,25,26,27,29,30,31,32,33,34
48,49,50,51,48,49,50,51,48,49,50,51,48,49,50,51,48,49,50,51,48,49,50,51,53,54,55,56,57,58
72,73,74,75,72,73,74,75,72,73,74,75,72,73,74,75,72,73,74,75,72,73,74,75,77,78,79,80,81,82
96,97,98,99,96,97,98,99,96,97,98,99,96,97,98,99,96,97,98,99,96,97,98,99,101,102,103,104,105,106
120,121,122,123,120,121,122,123,120,121,122,123,120,121,122,123,120,121,122,123,120,121,122,123,125,126,127,128,129,130
144,145,146,147,144,145,146,147,144,145,146,147,144,145,146,147,144,145,146,45,44,145,146,147,149,150,151,152,153,154
168,169,170,171,168,169,170,171,168,169,170,171,168,169,170,171,168,169,170,71,70,169,170,171,173,174,175,176,177,178
